1000000000000000001
1000000000000000001
1000000001000000001
1000000011100000001
1000000111110000001
1000001111111000001
1000011111111100001
1000000000000000001
1111110000000111111
1000000000000000001
1000000000111111111
1000000000000000001
1111111111000000001
1000000000000000001
1000000000000000001